GGG GGG GGG GGG GGG GGG GGG GGG GGG GGG GGG GGG GGG GGG GGG GGG GGG GGG GGG GGG GGG GGG GGG GGG GGG GGG GGG SBO SBO SBO
TTT TTT TTT TTT TTT TTT TTT TTT TTT TTT TTT TTT TTT TTT TTT TTT TTT TTT TTT TTT TTT TTT TTT TTT TTT TTT TTT TTT TTT TTT
TTT GGG GGG GGG GGG GGG TTT TTT GGG TTT GGG GGG GGG GGG GGG RRR KEY RRR RRR RRR RRR RRR GGG TTT GGG GGG GGG GGG GGG TTT
TTT GGG TTT GGG TTT GGG TTT TTT GGG TTT GGG RRR RRR RRR RRR RRR RRR RRR RRR RRR GGG GGG GGG GGG GGG GGG GGG TTT GGG TTT
TTT GGG GGG GGG GGG GGG TTT GGG GGG TTT GGG RRR AXE RRR RRR RRR RRR RRR RRR GGG GGG GGG GGG GGG GGG TTT GGG GGG GGG TTT
TTT TTT GGG TTT GGG TTT GGG GGG GGG TTT RRR RRR RRR RRR RRR RRR RRR RRR RRR GGG GGG GGG TTT GGG GGG GGG GGG GGG GGG TTT
TTT GGG GGG GGG GGG GGG TTT GGG GGG TTT GGG GGG GGG GGG GGG GGG GGG GGG GGG GGG GGG TTT GGG GGG GGG TTT TTT TTT TTT TTT
TTT GGG GGG GGG GGG GGG GGG GGG GGG TTT GGG TTT GGG TTT GGG GGG TTT GGG GGG GGG TTT GGG GGG TTT GGG GGG TTT TTT TTT TTT
TTT GGG GGG TTT GGG GGG GGG GGG GGG SSS GGG GGG GGG GGG GGG GGG GGG GGG GGG GGG GGG GGG GGG TTT GGG GGG GGG TTT TTT TTT
TTT GGG TTT GGG GGG GGG GGG GGG GGG GGG GGG GGG GGG GGG GGG TTT GGG GGG GGG GGG GGG GGG GGG TTT GGG GGG GGG GGG SSS TTT
TTT GGG GGG GGG GGG GGG GGG GGG GGG TTT GGG TTT GGG GGG GGG GGG GGG TTT GGG GGG TTT GGG GGG TTT GGG GGG GGG RRR GGG TTT
TTT GGG GGG GGG GGG GGG GGG GGG GGG TTT GGG GGG GGG TTT GGG GGG GGG GGG GGG GGG GGG TTT GGG TTT GGG GGG RRR GGG GGG TTT
TTT GTO GTO GTO GTO GTO TTT GTR GGG GGG GGG GGG GGG GGG GGG TTT GGG GGG TTT GGG GGG GGG GGG GGG GGG RRR GGG GGG GGG TTT
TTT GGG TTT GGG GGG GGG SSS GRO GGG GGG GGG GGG GGG GGG GGG GGG GGG GGG GGG GGG GGG GGG GGG GGG RRR GGG GGG GGG PPP TTT
TTT GGG TTT GGG TTT GGG TTT GRO GGG GGG GGG GGG TTT GGG GGG GGG GGG GGG GGG TTT GGG TTT GGG GGG GGG RRR GGG GGG GGG TTT
TTT GGG DDD GGG TTT SSS TTT GRO GGG GGG GGG GGG GGG TTT GGG GGG TTT GGG GGG GGG GGG GGG GGG GGG GGG GGG RRR GGG GGG TTT
TTT GBO GBO GBO TTT GBO GGG GBR GGG GGG GGG TTT GGG GGG TTT GGG GGG GGG GGG GGG GGG GGG GGG TTT GGG GGG GGG RRR GGG TTT
TTT RBL RBO RBO RBO RBO STP RBR GGG GGG GGG GGG GGG GGG GGG GGG GGG TTT GGG GGG GGG TTT GGG GGG GGG TTT GGG GGG RRR TTT
TTT GGG GGG GGG GGG GGG GGG GGG GGG TTT GGG GGG GGG GGG GGG GGG GGG GGG GGG GGG GGG GGG GGG GGG GGG GGG GGG GGG GGG TTT
TTT TTT TTT TTT TTT TTT TTT TTT TTT TTT TTT TTT TTT TTT TTT TTT TTT TTT TTT TTT TTT TTT TTT TTT TTT TTT TTT TTT TTT TTT