GGG GGG GGG GGG GGG GGG GGG GGG GGG GGG GGG GGG GGG GGG GGG GGG GGG GGG GGG GGG GGG GGG GGG GGG GGG GGG GGG GGG SBO SBO
TTT TTT TTT TTT TTT TTT TTT TTT TTT TTT TTT TTT TTT TTT TTT TTT TTT TTT TTT TTT TTT TTT TTT TTT TTT TTT TTT TTT TTT TTT
TTT GGG GGG GGG GGG GGG GGG TTT GGG GGG GGG GGG GGG GGG GGG GGG GGG GGG RRR GGG GGG RRR GGG GGG PPP GGG GGG RRR GGG TTT
TTT GGG GGG GGG TTT GGG TTT GGG GGG TTT GGG GGG TTT GGG TTT GGG GGG RRR GGG RRR GGG RRR RRR GGG GGG GGG RRR GGG RRR TTT
TTT GGG GGG GGG GGG GGG GGG GGG GGG TTT GGG GGG GGG GGG GGG GGG GGG GGG RRR GGG RRR GGG RRR RRR GGG RRR GGG RRR GGG TTT
TTT GGG GGG TTT GGG GGG GGG TTT GGG GGG TTT GGG TTT GGG GGG TTT GGG RRR GGG RRR AXE GGG RRR RRR RRR GGG RRR GGG GGG TTT
TTT GGG GGG GGG TTT GGG TTT GGG GGG TTT GGG TTT GGG GGG TTT GGG GGG GGG RRR GGG RRR GGG GGG RRR GGG RRR GGG GGG RRR TTT
TTT GGG GGG TTT GGG GGG GGG GGG GGG GGG GGG GGG GGG GGG GGG GGG TTT GGG GGG RRR GGG RRR GGG GGG RRR GGG GGG RRR GGG TTT
TTT GGG GGG GGG GGG GGG GGG GGG GGG TTT GGG TTT GGG GGG GGG GGG GGG GGG GGG GGG RRR GGG RRR GGG GGG GGG RRR RRR OOO TTT
TTT GGG TTT GGG GGG TTT GGG TTT GGG GGG GGG GGG TTT GGG GGG GGG GGG GGG GGG GGG GGG RRR GGG RRR GGG RRR GGG RRR GGG TTT
TTT GGG GGG GGG TTT GGG GGG GGG GGG TTT GGG GGG GGG TTT GGG GGG GGG TTT GGG GGG RRR GGG RRR GGG SSS GGG RRR GGG RRR TTT
TTT GGG GGG GGG GGG GGG GGG GGG GGG TTT TTT GGG GGG GGG TTT GGG GGG GGG GGG GGG GGG GGG GGG RRR GGG GGG GGG RRR GGG TTT
TTT GGG GGG TTT GGG GGG TTT GGG GGG GGG GGG TTT GGG GGG GGG GGG GGG GGG GGG GGG GGG GGG GGG GGG RRR GGG GGG GGG GGG TTT
TTT TTT GGG GGG GGG GGG GGG GGG GGG GGG GGG GGG TTT GGG GGG TTT GGG GGG TTT GGG GGG GGG GGG GGG GGG RRR GGG GGG GGG TTT
TTT GGG GGG GGG TTT GGG TTT GGG GGG TTT GGG GGG GGG GGG GGG GGG GGG RRR GGG GGG GGG RRR GGG GGG GGG GGG RRR GGG RRR TTT
TTT GGG TTT GGG GGG GGG GGG GGG TTT GGG GGG TTT GGG TTT GGG GGG RRR GGG RRR GGG RRR GGG RRR GGG RRR GGG GGG RRR GGG TTT
TTT GGG GGG GGG GGG GGG GGG TTT GGG GGG GGG GGG GGG GGG GGG RRR GGG GGG GGG RRR RRR GGG GGG RRR GGG GGG GGG GGG RRR TTT
TTT GGG GGG TTT GGG GGG TTT GGG GGG GGG TTT GGG TTT GGG RRR RRR GGG GGG RRR RRR RRR GGG GGG GGG RRR RRR RRR RRR GGG TTT
TTT GGG GGG GGG GGG GGG GGG GGG GGG RRR GGG GGG GGG GGG RRR GGG GGG GGG GGG GGG GGG GGG RRR GGG GGG GGG GGG GGG GGG TTT
TTT TTT TTT TTT TTT TTT TTT TTT TTT TTT TTT TTT TTT TTT TTT TTT TTT TTT TTT TTT TTT TTT TTT TTT TTT TTT TTT TTT TTT TTT