GGG GGG GGG GGG GGG GGG GGG GGG GGG GGG GGG GGG GGG GGG GGG GGG GGG GGG GGG GGG GGG GGG GGG GGG GGG GGG GGG SBO SBO SBO
TTT TTT TTT TTT TTT TTT TTT TTT TTT TTT TTT TTT TTT TTT TTT TTT TTT TTT TTT TTT TTT TTT TTT TTT TTT TTT TTT TTT TTT TTT
TTT GGG GGG GGG GGG GGG GGG TTT TTT TTT TTT TTT TTT GGG GGG GGG TTT TTT GGG TTT TTT GGG GGG RRR RRR RRR AXE GGG GGG TTT
TTT TTT TTT GGG GGG TTT GGG TTT TTT TTT TTT TTT GGG GGG TTT GGG GGG GGG TTT GGG GGG GGG GGG RRR RRR RRR GGG GGG GGG TTT
TTT GGG GGG GGG GGG GGG GGG GGG TTT TTT TTT TTT GGG GGG GGG GGG GGG GGG GGG GGG GGG RRR GGG GGG RRR RRR GGG GGG GGG TTT
TTT GGG GGG TTT GGG GGG TTT GGG GGG TTT TTT GGG GGG GGG GGG TTT GGG GGG GGG GGG TTT GGG RRR TTT RRR RRR GGG GGG GGG TTT
TTT TTT GGG GGG GGG TTT GGG GGG RRR RRR TTT TTT GGG TTT TTT GGG GGG TTT GGG TTT TTT TTT RRR GGG RRR RRR GGG GGG GGG TTT
TTT GGG GGG GGG GGG GGG TTT GGG RRR RRR TTT TTT GGG GGG GGG GGG GGG TTT TTT GGG TTT TTT GGG GGG GGG GGG GGG GGG GGG TTT
TTT GGG GGG TTT TTT GGG GGG GGG GGG RRR GGG GGG TTT GGG GGG GGG TTT TTT GGG TTT GGG GGG TTT RRR GGG RRR TTT GGG GGG TTT
TTT GGG GGG GGG GGG GGG GGG GGG GGG RRR RRR GGG GGG GGG TTT TTT GGG GGG TTT GGG TTT GGG TTT GGG GGG GGG GGG GGG GGG TTT
TTT TTT GGG GGG GGG GGG GGG GGG RRR RRR RRR TTT GGG TTT GGG GGG TTT TTT GGG GGG GGG TTT TTT TTT GGG GGG GGG RRR RRR TTT
TTT GGG GGG GGG GGG TTT GGG GGG GGG RRR RRR GGG TTT GGG GGG GGG GGG TTT GGG TTT GGG GGG TTT GGG TTT RRR RRR RRR RRR TTT
TTT PPP GGG TTT GGG GGG GGG GGG GGG RRR RRR GGG GGG GGG TTT TTT GGG GGG GGG TTT TTT GGG GGG TTT GGG GGG TTT RRR RRR TTT
TTT GGG GGG GGG GGG GGG TTT GGG RRR RRR GGG GGG TTT GGG TTT GGG TTT GGG TTT GGG GGG GGG TTT GGG GGG GGG TTT RRR OOO TTT
TTT GGG GGG GGG GGG TTT GGG RRR GGG RRR RRR GGG TTT GGG GGG TTT TTT TTT GGG TTT TTT GGG GGG TTT TTT GGG TTT RRR RRR TTT
TTT GGG TTT GGG GGG GGG TTT GGG GGG RRR RRR TTT GGG GGG GGG TTT GGG GGG TTT TTT TTT TTT GGG GGG GGG GGG GGG SSS RRR TTT
TTT GGG GGG TTT GGG GGG GGG GGG TTT RRR RRR GGG GGG TTT GGG GGG TTT GGG GGG RRR TTT GGG TTT TTT GGG GGG TTT GGG TTT TTT
TTT TTT GGG GGG TTT GGG GGG GGG RRR RRR RRR TTT GGG GGG TTT GGG GGG GGG TTT RRR GGG GGG TTT GGG TTT GGG TTT GGG GGG TTT
TTT GGG GGG GGG GGG GGG TTT GGG GGG RRR RRR GGG GGG GGG GGG GGG TTT GGG TTT RRR TTT GGG GGG GGG GGG GGG TTT GGG GGG TTT
TTT TTT TTT TTT TTT TTT TTT TTT TTT TTT TTT TTT TTT TTT TTT TTT TTT TTT TTT TTT TTT TTT TTT TTT TTT TTT TTT TTT TTT TTT