GGG GGG GGG GGG GGG GGG GGG GGG GGG GGG GGG GGG GGG GGG GGG GGG GGG GGG GGG GGG GGG GGG GGG GGG GGG GGG SBO SBO X Y
TTT TTT TTT TTT TTT TTT TTT TTT TTT TTT TTT TTT TTT TTT TTT TTT TTT TTT TTT TTT TTT TTT TTT TTT TTT TTT TTT TTT TTT TTT
TTT GGG GGG GGG SSS SSS TTT TTT GGG TTT GGG TTT SSS TTT GGG PPP TTT GGG GGG GGG GGG GGG GGG GGG GGG GGG GGG GGG GGG TTT
TTT GGG GGG GGG SSS GGG GGG GGG GGG TTT GGG GGG GGG GGG GGG GGG GGG GGG GGG GGG GGG GGG GGG GGG GGG GGG GGG GGG GGG TTT
TTT GGG GGG GGG GGG GGG GGG GGG GGG TTT GGG GGG GGG GGG GGG GGG GGG GGG GGG GGG GGG GGG GGG GGG GGG GGG GGG GGG GGG TTT
TTT GGG GGG TTT GGG GGG GGG GGG GGG GGG GGG GGG GGG GGG GGG TTT GGG GGG GGG GGG GGG GGG GGG GGG GGG GGG GGG GGG GGG TTT
TTT GGG GGG GGG GGG GGG TTT GGG GGG TTT GGG GGG GGG GGG GGG GGG GGG GGG GGG GGG GGG GGG GGG TTT GGG GGG GGG GGG GGG TTT
TTT GGG GGG GGG GGG GGG GGG GGG GGG TTT GGG GGG GGG GGG GGG GGG GGG GGG GGG GGG GGG GGG GGG GGG GGG GGG GGG TTT GGG TTT
TTT GGG GGG GGG GGG GGG GGG GGG GGG TTT GGG GGG GGG GGG GGG GGG GGG GGG GGG GGG GGG GGG GGG GGG GGG GGG GGG GGG GGG TTT
TTT GGG GGG SSS GGG GGG GGG GGG GGG GGG GGG GGG GGG GGG GGG GGG GGG GGG GGG GGG GGG GGG GGG GGG GGG GGG GGG TTT GGG TTT
TTT TTT GGG GGG GGG GGG GGG GGG GGG TTT GGG GGG GGG GGG GGG GGG GGG GGG GGG GGG TTT GGG GGG GGG GGG GGG GGG GGG GGG TTT
TTT TTT TTT GGG GGG GGG GGG GGG GGG TTT GGG GGG GGG GGG GGG GGG GGG GGG GGG GGG GGG GGG GGG GGG GGG GGG GGG GGG GGG TTT
TTT OOO SSS GGG GGG GGG GGG GGG GGG GGG GGG GGG GGG GGG GGG GGG GGG GGG GGG GGG GGG GGG GGG GGG TTT GGG GGG GGG GGG TTT
TTT TTT TTT GGG GGG GGG GGG GGG GGG GGG GGG GGG GGG GGG GGG GGG GGG GGG GGG GGG GGG GGG GGG GGG GGG GGG GGG GGG GGG TTT
TTT TTT GGG GGG GGG GGG GGG GGG GGG GGG GGG RRR GGG GGG GGG GGG GGG GGG GGG GGG GGG TTT GGG GGG GGG GGG GGG GGG GGG TTT
TTT GGG GGG GGG GGG GGG GGG GGG RRR RRR RRR RRR RRR RRR RRR SSS RRR GGG GGG GGG TTT GGG TTT GGG TTT GGG GGG GGG GGG TTT
TTT GGG GGG GGG GGG GGG GGG GGG RRR RRR RRR RRR RRR RRR RRR RRR RRR GGG GGG TTT TTT GGG GGG TTT GGG SSS GGG GGG GGG TTT
TTT GGG GGG GGG GGG GGG GGG RRR RRR RRR RRR RRR RRR RRR TTT RRR RRR RRR RRR TTT TTT GGG GGG GGG TTT TTT TTT TTT GGG TTT
TTT GGG GGG GGG GGG GGG RRR RRR RRR TTT AXE TTT RRR RRR KEY RRR DDD RRR RRR GGG GGG GGG TTT GGG GGG GGG GGG GGG GGG TTT
TTT TTT TTT TTT TTT TTT TTT TTT TTT TTT TTT TTT TTT TTT TTT TTT TTT TTT TTT TTT TTT TTT TTT TTT TTT TTT TTT TTT TTT TTT