GGG GGG GGG GGG GGG GGG GGG GGG GGG GGG GGG GGG GGG GGG GGG GGG GGG GGG GGG GGG GGG GGG GGG GGG EEE EEE EEE SBO AOV KOV
TTT TTT TTT TTT TTT TTT TTT TTT TTT TTT TTT TTT TTT TTT TTT TTT TTT TTT TTT TTT TTT TTT TTT TTT TTT TTT TTT TTT TTT TTT
TTT GGG GGG GGG SSS SSS GGG GGG GGG RRR GGG GGG TTT GGG GGG GGG GGG TTT GGG GGG GGG GGG GGG GGG GGG GGG GGG GGG GGG TTT
TTT GGG GGG GGG SSS TTT GGG GGG GGG RRR GGG GGG GGG GGG GGG GGG GGG GGG GGG TTT GGG GGG GGG GGG GGG GGG GGG GGG GGG TTT
TTT GGG GGG GGG GGG GGG GGG TTT SSS TTT GGG GGG GGG GGG GGG GGG GGG GGG GGG GGG GGG GGG GGG GGG GGG GGG GGG GGG GGG TTT
TTT GGG GGG PPP GGG GGG GGG GGG GGG GGG GGG TTT GGG GGG GGG TTT GGG GGG GGG GGG GGG GGG GGG TTT GGG GGG GGG GGG GGG TTT
TTT GGG GGG GGG TTT GGG GGG GGG GGG GGG GGG GGG GGG GGG GGG GGG GGG GGG GGG GGG TTT GGG GGG GGG GGG GGG GGG GGG GGG TTT
TTT GGG GGG GGG GGG GGG TTT GGG GGG GGG GGG GGG GGG GGG GGG GGG GGG GGG GGG GGG GGG GGG GGG GGG GGG GGG GGG GGG GGG TTT
TTT GGG GGG GGG GGG GGG GGG GGG GGG GGG GGG GGG TTT GGG GGG GGG GGG TTT GGG GGG GGG GGG TTT GGG GGG GGG TTT GGG GGG TTT
TTT GGG GGG SSS GGG GGG GGG TTT GGG GGG GGG GGG GGG GGG GGG GGG GGG GGG GGG GGG GGG GGG GGG GGG GGG GGG GGG GGG GGG TTT
TTT GGG GGG GGG GGG GGG GGG GGG GGG GGG GGG GGG GGG GGG GGG GGG GGG GGG GGG TTT GGG GGG GGG TTT GGG GGG GGG GGG GGG TTT
TTT GGG GGG GGG GGG TTT GGG GGG GGG TTT GGG GGG TTT GGG GGG GGG GGG GGG GGG GGG GGG GGG GGG GGG GGG GGG GGG TTT TTT TTT
TTT GGG GGG GGG GGG GGG TTT GGG GGG GGG GGG GGG GGG GGG GGG GGG GGG GGG GGG GGG GGG GGG GGG TTT GGG GGG TTT GGG GGG TTT
TTT GGG GGG GGG GGG GGG GGG GGG GGG GGG GGG GGG GGG GGG GGG GGG GGG TTT TTT GGG GGG GGG GGG GGG GGG TTT GGG GGG DDD TTT
TTT GGG GGG GGG GGG GGG GGG GGG GGG GGG GGG TTT GGG GGG GGG GGG GGG GGG GGG GGG GGG GGG TTT TTT TTT RRR TTT GGG TTT TTT
TTT GGG GGG TTT GGG GGG TTT GGG GGG GGG GGG GGG GGG GGG GGG SSS GGG GGG GGG TTT TTT TTT GGG GGG RRR KEY TTT GGG GGG TTT
TTT GGG GGG GGG GGG GGG GGG GGG TTT GGG GGG GGG GGG GGG GGG GGG TTT GGG GGG GGG TTT GGG TTT GGG TTT RRR GGG GGG TTT TTT
TTT GGG GGG GGG GGG GGG GGG GGG GGG TTT GGG GGG GGG GGG GGG GGG TTT GGG TTT GGG GGG GGG GGG GGG GGG TTT RRR GGG GGG TTT
TTT GGG GGG GGG GGG GGG GGG GGG AXE TTT GGG GGG GGG GGG GGG GGG TTT GGG TTT GGG TTT TTT GGG GGG GGG RRR GGG GGG GGG TTT
TTT TTT TTT TTT TTT TTT TTT TTT TTT TTT TTT TTT TTT TTT TTT TTT TTT TTT TTT TTT TTT TTT TTT TTT TTT TTT TTT TTT TTT TTT