GGG GGG GGG GGG GGG GGG GGG GGG GGG GGG GGG GGG GGG GGG GGG GGG GGG GGG GGG GGG GGG GGG GGG GGG GGG GGG GGG GGG GGG GGG
TTT TTT TTT TTT TTT TTT TTT TTT TTT TTT TTT TTT TTT TTT TTT TTT TTT TTT TTT TTT TTT TTT TTT TTT TTT TTT TTT TTT TTT TTT
TTT TTT GGG GGG GGG TTT GGG GGG GGG TTT GGG GGG GGG GGG GGG TTT GGG GGG GGG GGG GGG TTT GGG GGG GGG GGG TTT GGG GGG TTT
TTT TTT GGG TTT GGG TTT GGG GGG GGG GGG GGG GGG TTT GGG GGG GGG GGG GGG TTT GGG GGG GGG TTT GGG GGG GGG GGG GGG GGG TTT
TTT PP1 GGG TTT GGG TTT GGG TTT GGG TTT TTT TTT TTT TTT TTT TTT TTT TTT TTT GGG TTT GGG GGG GGG GGG TTT GGG GGG GGG TTT
TTT TTT TTT TTT GGG TTT GGG GGG GGG GGG GGG TTT GGG GGG GGG GGG GGG GGG TTT GGG GGG TTT GGG TTT GGG GGG GGG GGG GGG TTT
TTT GGG GGG GGG GGG TTT GGG GGG GGG GGG GGG GGG GGG GGG GGG TTT GGG GGG TTT GGG GGG GGG GGG GGG TTT GGG TTT GGG GGG TTT
TTT GGG TTT TTT TTT TTT TTT TTT TTT TTT TTT TTT TTT TTT TTT TTT TTT GGG TTT TTT GGG GGG TTT GGG GGG GGG GGG GGG TTT TTT
TTT GGG GGG GGG GGG GGG TTT GGG GGG GGG GGG TTT GGG GGG GGG GGG TTT GGG TTT GGG GGG TTT GGG GGG GGG TTT GGG GGG GGG TTT
TTT GGG GGG TTT GGG GGG GGG GGG GGG TTT GGG GGG GGG GGG TTT GGG GGG GGG TTT GGG GGG GGG GGG TTT GGG GGG TTT GGG OOO TTT
TTT TTT TTT TTT TTT TTT TTT TTT TTT TTT TTT TTT TTT TTT TTT TTT TTT TTT TTT TTT TTT TTT TTT TTT TTT TTT TTT TTT TTT TTT
TTT TTT GGG GGG GGG TTT GGG GGG GGG TTT GGG GGG GGG GGG GGG TTT GGG GGG GGG GGG GGG TTT GGG GGG GGG GGG TTT GGG GGG TTT
TTT TTT GGG TTT GGG TTT GGG GGG GGG GGG GGG GGG TTT GGG GGG GGG GGG GGG TTT GGG GGG GGG TTT GGG GGG GGG GGG GGG GGG TTT
TTT PP2 GGG TTT GGG TTT GGG TTT GGG TTT TTT TTT TTT TTT TTT TTT TTT TTT TTT GGG TTT GGG GGG GGG GGG TTT GGG GGG GGG TTT
TTT TTT TTT TTT GGG TTT GGG GGG GGG GGG GGG TTT GGG GGG GGG GGG GGG GGG TTT GGG GGG TTT GGG TTT GGG GGG GGG GGG GGG TTT
TTT GGG GGG GGG GGG TTT GGG GGG GGG GGG GGG GGG GGG GGG GGG TTT GGG GGG TTT GGG GGG GGG GGG GGG TTT GGG TTT GGG GGG TTT
TTT GGG TTT TTT TTT TTT TTT TTT TTT TTT TTT TTT TTT TTT TTT TTT TTT GGG TTT TTT GGG GGG TTT GGG GGG GGG GGG GGG TTT TTT
TTT GGG GGG GGG GGG GGG TTT GGG GGG GGG GGG TTT GGG GGG GGG GGG TTT GGG TTT GGG GGG TTT GGG GGG GGG TTT GGG GGG GGG TTT
TTT GGG GGG TTT GGG GGG GGG GGG GGG TTT GGG GGG GGG GGG TTT GGG GGG GGG TTT GGG GGG GGG GGG TTT GGG GGG TTT GGG OOO TTT
TTT TTT TTT TTT TTT TTT TTT TTT TTT TTT TTT TTT TTT TTT TTT TTT TTT TTT TTT TTT TTT TTT TTT TTT TTT TTT TTT TTT TTT TTT