GGG GGG GGG GGG GGG GGG GGG GGG GGG GGG GGG GGG GGG GGG GGG GGG GGG GGG GGG GGG GGG GGG GGG GGG EEE SBO SBO SBO X Y
TTT TTT TTT TTT TTT TTT TTT TTT TTT TTT TTT TTT TTT TTT TTT TTT TTT TTT TTT TTT TTT TTT TTT TTT TTT TTT TTT TTT TTT TTT
TTT GGG GGG GGG GGG GGG GGG GGG GGG GGG GGG GGG GGG GGG GGG GGG GGG GGG GGG GGG GGG GGG GGG GGG GBO GBO GGG RRR DDD TTT
TTT GBO GBO GBO GBO GBO GBO GBO GBO GBO GBO GBO GBO GBO GBO GGG GGG GGG GGG GGG GGG GGG GRO RBO RBO RBO GBL GBO TTT TTT
TTT RBO RBO RBO RBO RBO RBO RBO RBO RBO RBO RBO RBO RBO RBO GLO GGG GGG GGG GGG GGG GGG GRO AXE TTT TTT RBL RBO RBO TTT
TTT GGG GGG PPP GGG GGG GGG GGG GGG GGG GGG GGG GGG GGG GGG GLO GGG GGG GGG GGG GGG GGG GRO GGG GGG GGG RRR GGG GGG TTT
TTT GGG GGG GGG GGG GGG GGG GGG GGG GGG GGG GGG GGG GGG GGG GBL GBO GGG GBO GBO GBO GBO GBR GGG GGG GGG GGG GGG RRR TTT
TTT GGG GGG GGG GGG GGG TTT GGG GGG GGG GGG GGG GGG GGG GGG RBL RBO STP RBO RBO RBO RBO RBR GGG RRR GGG GGG RRR GGG TTT
TTT GGG GGG GGG GGG GGG GGG GGG GGG GGG GGG GGG TTT GGG GGG GGG GGG GGG GGG GGG GGG GGG TTT RRR GGG RRR TTT GGG GGG TTT
TTT GGG GGG SSS GGG GGG GGG GGG GGG GGG GGG GGG GGG GGG GGG GGG GGG TTT GGG GGG GGG GGG RRR GGG GGG GGG GGG GGG GGG TTT
TTT GGG GGG GGG GGG GGG GGG GGG GGG GGG GGG GGG GGG GGG GGG GGG GGG GGG GGG GGG GGG GGG GGG TTT GGG GGG GGG GGG GGG TTT
TTT GGG GGG GGG GGG TTT GGG GGG GGG GGG GGG GGG TTT GGG GGG GGG GGG GGG GGG GGG GGG GGG GGG RRR GGG GGG GGG TTT TTT TTT
TTT GTO GTO GTO GTO GTO GTO GTO GTO GTO GTO GTO GTO GTO GTO GTR GGG GGG GGG GGG GGG GGG GGG TTT GGG GGG TTT GGG GGG TTT
TTT TTT GGG GGG GGG GGG GGG GGG GGG GGG GGG GGG GGG GGG GGG GRO GGG TTT TTT GGG GGG GGG GGG GGG RRR TTT GGG GGG GGG TTT
TTT TTT GGG GGG GGG GGG GGG GGG GGG GGG GGG GGG GGG GGG GGG GRO GGG GGG GGG GGG GGG GGG TTT TTT TTT GGG GGG TTT TTT TTT
TTT GGG GGG GGG TTT TTT TTT GBO GGG GGG GGG GGG GGG GGG GGG GRO GGG GGG GGG TTT TTT TTT GGG GGG GGG GGG GGG GGG GGG TTT
TTT GGG RRR GRO RBO RBO RBO RBO GBL GBO GBO GBO GBO GGG GBO GBR TTT GGG GGG GGG TTT GGG TTT GGG GGG GGG TTT GGG TTT TTT
TTT RRR RRR GRO GGG GGG GGG GGG RBL RBO RBO RBO RBO STP RBO RBR TTT GGG TTT GGG GGG GGG TTT GGG GGG GGG TTT RRR OOO TTT
TTT KEY TTT GRO GGG GGG GGG GGG GGG TTT GGG GGG GGG GGG GGG GGG RRR RRR TTT GGG TTT GGG GGG GGG GGG GGG SSS TTT TTT TTT
TTT TTT TTT TTT TTT TTT TTT TTT TTT TTT TTT TTT TTT TTT TTT TTT TTT TTT TTT TTT TTT TTT TTT TTT TTT TTT TTT TTT TTT TTT